WWWWWW
W    F
W WWWW
W    W
WWWW W
WP   W
WWWWWW
---
WWWWWWW
WP    W
WWW WWW
  WWW
---
WWWWWWWFW
W W W W W
W W W W W
W W W W W
W W W W W
W W W W W
W   P   W
WWWWWWWWW
---
WWWWWWWWWWWWWWWWWW
WP               W
WWWWWWWWWWWWWWWW W
W                W
WFWWWWWWWWWWWWWW W
WW               W
WWWWWWWWWWWWWWWWWW
---
WWWWWWWWWWW
WPW W     W
W     WWW W
W WWWWW W W
W W WFW W W
W   W W   W
WWWWW WWW W
W         W
WWWWWWWWWWW
---
WFWWWWWWWW
W W      W
W WWWWWW W
W W W    W
W      W W
WWWWWWWW W
W        W
WW WWWWWWW
W       PW
WWWWWWWWWW
---
WWWWWWWWWW
WPW      F
W W WWWWWW
W W    WWW 
W WWWW   W
W    WWW W
W W      W
W WWWWWW W
W        W
WWWWWWWWWW