WFWWWWWWWW
W W      W
W WWWWWW W
W W W    W
W      W W
WWWWWWWW W
W        W
WW WWWWWWW
W       PW
WWWWWWWWWW
---
WWWWWWWWWW
WPW      F
W W WWWWWW
W W    WWW 
W WWWW   W
W    WWW W
W W      W
W WWWWWW W
W        W
WWWWWWWWWW